00000000000000000000000000000000000000000
54442302672704758744239609897969015531740
09000500080306060000000408000900010000060
06069541140946040435077702010784880587420
00020000000000090008020004010000000900000
05250367140249010972079807032682490836530
09000005070002050600000802000200040000050
07286504090294070789348709077602160266210
00000606080700080000070003080004000004000
04568207080233010526082989038301881821060
02000000010305030002000000000900000004080
09444912430807750816025801280702710127030
00000000000600020600000901090408020008060
07634872029207230701730789090709035158020
02000003040000000904050000020408000000080
04910729090429030223080797010807231783030
08030900030508040001080907030600000000070
04090801020102075404090203611306759901730
00080708090907030908040200000007000703010
02750805720508950608030498382509540672040
03000803000500000407030000000200040000000
02360603091502474404059206220137060821690
00030209030005000007000103000005020900050
09050451085806210293085108194508020728070
04070000000600040200070000000208040000020
07368401283208520611025603790974960793020
00000102000008000001000800040006000108010
08870895013266021483084454091974040503760
04000000070000000300080002030000080500000
05054876810503560207460977025151041248050
07010000000909090901000200000004000004080
03080308247406090406079401447452095573070
04050804030003020202030003000000000600050
09025452095978071401090834029102210347280
02010000010000000008050001040201050003000
03058963090234985591040327020401057602090
01000000050600000000030900080706000302040
01056853260405918807010804330119180769070
08040007030800000203060506000000030000060
01840158050378219409550176028523896554896
00000000000000000000000000000000000000000
|
goal / energy
20 4079
|
position
0 1
|
15 12
31 31
27 12
37 5
6 11
15 35
13 33
15 39
13 2
19 26
34 13
11 20
33 37
23 33
13 32
36 19
38 17
3 32
33 11
25 27
