0000000000000000000000000000000
1307517608296135048801654539070
0105000606000000040508000008080
0306067997015605260801958308080
0601070700010201000300000805070
0342080221070841065604756806060
0000010001070000050008000009090
0706760179036308370694050532060
0506000700000908000000020203040
0342019364057602013805990207030
0000000001050008040301000100070
0368120941060767020906554408490
0300090600020300080400070007000
0305070328190344330591290388720
0304040000000800000500000900070
0607090904256407045205161506210
0802080806030004090801000006000
0905077432076606060504670307340
0808000000000608050000010100080
0816677567330738055264510622568
0000000000000000000000000000000
|
goal / energy
16 1302
|
position
0 1
|
21 5
14 13
19 19
17 3
20 19
22 5
23 15
3 13
15 5
6 17
7 7
17 17
3 1
9 2
1 18
9 9
